6.000000000000000000e+00
7.483314773547882659e+00
1.048808848170151542e+01
1.421267040355189515e+01
1.392838827718411920e+01
1.392838827718411920e+01
1.104536101718726115e+01
2.362202362203543160e+01
2.572936066053721405e+01
2.908607914449797249e+01
5.099019513592784492e+00
1.363818169698585514e+01
1.749285568453590045e+01
1.435270009440732331e+01
1.157583690279022548e+01
2.167948338867880054e+01
2.102379604162863913e+01
2.083266665599965961e+01
1.392838827718411920e+01
1.923538406167134340e+01
1.984943324127920761e+01
1.743559577416269590e+01
1.697056274847713908e+01
2.009975124224177989e+01
2.271563338320109438e+01
2.592296279363144151e+01
2.846049894151541437e+01
2.004993765576342213e+01
2.817800560721074277e+01
2.387467277262664567e+01
1.994993734326000379e+01
1.886796226411320632e+01
1.881488772222677852e+01
1.964688270438849926e+01
1.392838827718411920e+01
1.516575088810310135e+01
8.366600265340755627e+00
8.602325267042626677e+00
7.071067811865475505e+00
1.749285568453590045e+01
8.602325267042626677e+00
9.486832980505138124e+00
1.349073756323204165e+01
1.363818169698585514e+01
1.421267040355189515e+01
2.044504830026087205e+01
1.870828693386970798e+01
1.516575088810310135e+01
8.366600265340755627e+00
1.691153452528776313e+01
