7.000000000000000000e+00
9.433981132056603158e+00
9.433981132056603158e+00
8.062257748298549132e+00
5.744562646538028616e+00
7.549834435270749822e+00
1.024695076595959797e+01
7.000000000000000000e+00
1.135781669160054719e+01
1.374772708486752038e+01
1.360147050873544394e+01
1.445683229480096088e+01
1.486606874731850603e+01
1.345362404707370985e+01
6.708203932499369415e+00
1.315294643796590535e+01
1.187434208703791683e+01
1.135781669160054719e+01
8.306623862918074863e+00
1.024695076595959797e+01
1.252996408614166768e+01
1.220655561573370207e+01
1.252996408614166768e+01
4.582575694955839829e+00
4.582575694955839829e+00
5.000000000000000000e+00
5.000000000000000000e+00
6.708203932499369415e+00
9.643650760992954929e+00
9.000000000000000000e+00
1.004987562112088995e+01
1.004987562112088995e+01
1.135781669160054719e+01
1.236931687685298087e+01
1.330413469565007034e+01
1.081665382639196871e+01
9.433981132056603158e+00
1.004987562112088995e+01
1.004987562112088995e+01
1.711724276862369010e+01
1.627882059609970611e+01
6.403124237432848531e+00
6.403124237432848531e+00
7.681145747868607820e+00
1.367479433117734366e+01
1.345362404707370985e+01
1.403566884761819900e+01
1.889444362769118513e+01
1.004987562112088995e+01
1.170469991071962568e+01
